############
#. $ #  $. ###
#. $ #       #
#. $ # ####  #
#. $   @ ##  #
#. $ # #    ##
###### ##    #
  #          #
  #.$  #     #
  ############