#####
# * #####
# .$@   #
##*   $.#
 #  #####
 ####